:==============================:
|------------------------------|
|------------------------------|
|------------------------------|
|------------------------------|
|------------------------------|
|--*---------------------------|
|------------------------------|
:==============================: