:============:
|------------|
|------------|
|--*---------|
|------------|
:============: